
wwwwwwwwwwwwwwww
      www      w
ww          w ww
wwww    ww wcwww
w        ww    w
www    ww    w w
www   www      w
ww    www    w w
www wwww w    ww
ww      www    w
ww        www  w
www www        w
www www ww     w
w      www     w
w wwww www     w
w ww           w
w        w www w
ww ww        w d
ww       cwwwwww
wwwwwwwwwwwwwwww
